nooooooooooooooooooooooooooooooooooooooooooooooooooooooooooooooooooooooooooooooooooooooooooooop
rdmjhgmjeEFdmjhgmjeEFdmjhgmjeEFdmjhgmjeEFdmjhgmjeEFdmjhgmjeEFdmjhgmjeEFdmjhgmjeEFdmjhgmjeEFdmjq
rDytttttttttttttttttttttttttttttttttttttttttttttttttttttttttttttttttttttttttttttttttttttttttxDq
r1q#########################################################################################r1q
r1q#########################################################################################r1q
rdq#########################################################################################rdq
req#########################################################################################req
rjq#########################################################################################rjq
r3q#########################################################################################r3q
r3q#########################################################################################r3q
r6q#########################################################################################r6q
r3q#########################################################################################r3q
rfq#########################################################################################rfq
rlq#########################################################################################rlq
rBq#########################################################################################rBq
rCq#########################################################################################rCq
rDq#########################################################################################rDq
r1q#########################################################################################r1q
r1q#########################################################################################r1q
rdq#########################################################################################rdq
req############nooooooooooooooooop########################nooooooooooooooooop###############r3q
r6q############r5zAmzA5dmzAgzAmzAq########################r5zAmzA5dmzAgzAmzAq###############r6q
r3q############rc8d222dzAlcd222d6q########################rc8d222dzAlcd222d6q###############r3q
rfq############rd9GHId222dGHIEFi3q########################rd9GHId222dGHIEFi3q###############rfq
rlq############rBcd4447d222dcdmg3q########################rBcd4447d222dcdmg3q###############rlq
rBq############rCGHId222dGHI3555eq########################rCGHId222dGHI3555eq###############rBq
rCq############rDzAmzA5dmzAgzAmzAq########################rDzAmzA5dmzAgzAmzAq###############rCq
rDq############stttttttttttttttttu########################stttttttttttttttttu###############r1q
rlq#########################################################################################rlq
rBq#########################################################################################rBq
rCq#########################################################################################rCq
rDq#########################################################################################rDq
r1q#########################################################################################r1q
r1q#########################################################################################r1q
rdq#########################################################################################rdq
req#########################################################################################req
rcq#########################################################################################rcq
rjq#########################################################################################rjq
r3q#########################################################################################r3q
r3q#########################################################################################r3q
r6q#########################################################################################r6q
r3q#########################################################################################r3q
rfq#########################################################################################rfq
rlq#########################################################################################rlq
rBq#########################################################################################rBq
rCq#########################################################################################rCq
rDq#########################################################################################rDq
r1q#########################################################################################r1q
r1q#########################################################################################r1q
rdq#########################################################################################rdq
req#########################################################################################req
rcq#########################################################################################rcq
rjq#########################################################################################rjq
r3q#########################################################################################r3q
r3q#########################################################################################r3q
r6q#########################################################################################r6q
r3q#########################################################################################r3q
rfq#########################################################################################rfq
rlq#########################################################################################rlq
rBq#########################################################################################rBq
rCq#########################################################################################rCq
rDq#########################################################################################rDq
r1q#########################################################################################r1q
r1q#########################################################################################r1q
rdq#########################################################################################rdq
req#########################################################################################req
rcq#########################################################################################rcq
rDq###########nooooooooooooooooop#############################nooooooooooooooooop###########rDq
r1q###########r5zAmzA5dmzAgzAmzAq#############################r5zAmzA5dmzAgzAmzAq###########r1q
r1q###########rc8d222dzAlcd222d6q#############################rc8d222dzAlcd222d6q###########r1q
rdq###########rd9GHId222dGHIEFi3q#############################rd9GHId222dGHIEFi3q###########rdq
req###########rBcd4447d222dcdmg3q#############################rBcd4447d222dcdmg3q###########req
rcq###########rCGHId222dGHI3555eq#############################rCGHId222dGHI3555eq###########rcq
rjq###########rDzAmzA5dmzAgzAmzAq#############################rDzAmzA5dmzAgzAmzAq###########rjq
r3q###########stttttttttttttttttu#############################stttttttttttttttttu###########r3q
rCq#########################################################################################rCq
rDq#########################################################################################rDq
r1q#########################################################################################r1q
r1q#########################################################################################r1q
rdq#########################################################################################rdq
req#########################################################################################req
rcq#########################################################################################rcq
rjq#########################################################################################rjq
r3q#########################################################################################r3q
r3q#########################################################################################r3q
r6q#########################################################################################r6q
r3q#########################################################################################r3q
rfq#########################################################################################rfq
rlq#########################################################################################rlq
rBq#########################################################################################rBq
rCq#########################################################################################rCq
rDq#########################################################################################rDq
r1wooooooooooooooooooooooooooooooooooooooooooooooooooooooooooooooooooooooooooooooooooooooooov1q
rdmjhgmjeEFdmjhgmjeEFdmjhgmjeEFdmjhgmjeEFdmjhgmjeEFdmjhgmjeEFdmjhgmjeEFdmjhgmjeEFdmjhgmjeEFdmjq
stttttttttttttttttttttttttttttttttttttttttttttttttttttttttttttttttttttttttttttttttttttttttttttu