wwwwwwwwwwwwwwwwwwwwwwwwwwwwwwwwwwwwwwwwwwwwwwwwwwwwwwwwwwwwwwwwwwwwwwwwwwwwwwwwwwwwwwwwwwwwwww
wwwwwwwwwwwwwwwwwwwwwwwwwwwwwwwwwwwwwwwwwwwwwwwwwwwwwwwwwwwwwwwwwwwwwwwwwwwwwwwwwwwwwwwwwwwwwww
wwwwwwwwwwwwwwwwwwwwwwwwwwwwwwwwwwwwwwwwwwwwwwwwwwwwwwwwwwwwwwwwwwwwwwwwwwwwwwwwwwwwwwwwwwwwwww
www#########################################################################################www
www#########################################################################################www
www#########################################################################################www
www#########################################################################################rew
www#########################################################################################rjw
www#########################################################################################r3w
www#########################################################################################r3w
www#########################################################################################r6w
www#########################################################################################r3w
www#########################################################################################rfw
www#########################################################################################rlw
www#########################################################################################rww
www#########################################################################################rww
www#########################################################################################rww
www#########################################################################################rww
www#########################################################################################rww
www#########################################################################################rww
www#########################################################################################rww
www#########################################################################################rww
www#########################################################################################rww
www#########################################################################################rww
www#########################################################################################rww
www#########################################################################################rww
www#########################################################################################rww
www#########################################################################################rww
www#########################################################################################rww
www#########################################################################################rww
www#########################################################################################rww
www#########################################################################################rww
www#########################################################################################rww
www#########################################################################################rww
www#########################################################################################rww
www#########################################################################################rww
www#########################################################################################rww
www#########################################################################################rww
www#########################################################################################rww
www#########################################################################################rww
www#########################################################################################rww
www#########################################################################################rww
www#########################################################################################rww
www#########################################################################################rww
www#########################################################################################rww
www#########################################################################################rww
www#########################################################################################rww
www#########################################################################################rww
www#########################################################################################rww
www#########################################################################################rww
www#########################################################################################rww
www#########################################################################################rww
www#########################################################################################rww
www#########################################################################################rww
www#########################################################################################rww
www#########################################################################################rww
www#########################################################################################rww
www#########################################################################################rww
www#########################################################################################rww
www#########################################################################################rww
www#########################################################################################rww
www#########################################################################################rww
www#########################################################################################rww
www#########################################################################################rww
www#########################################################################################rww
www#########################################################################################rww
www#########################################################################################rww
www#########################################################################################rww
www#########################################################################################rww
www#########################################################################################rww
www#########################################################################################rww
www#########################################################################################rww
www#########################################################################################rww
www#########################################################################################rww
www#########################################################################################rww
www#########################################################################################rww
www#########################################################################################rww
www#########################################################################################rww
www#########################################################################################rww
www#########################################################################################rww
www#########################################################################################rww
www#########################################################################################rww
www#########################################################################################rww
www#########################################################################################rww
www#########################################################################################rww
www#########################################################################################rww
www#########################################################################################rww
www#########################################################################################rww
www#########################################################################################rww
www#########################################################################################rww
www#########################################################################################rww
www#########################################################################################rww
wwwwwwwwwwwwwwwwwwwwwwwwwwwwwwwwwwwwwwwwwwwwwwwwwwwwwwwwwwwwwwwwwwwwwwwwwwwwwwwwwwwwwwwwwwwwwww
wwwwwwwwwwwwwwwwwwwwwwwwwwwwwwwwwwwwwwwwwwwwwwwwwwwwwwwwwwwwwwwwwwwwwwwwwwwwwwwwwwwwwwwwwwwwwww
wwwwwwwwwwwwwwwwwwwwwwwwwwwwwwwwwwwwwwwwwwwwwwwwwwwwwwwwwwwwwwwwwwwwwwwwwwwwwwwwwwwwwwwwwwwwwww